Pose	Type	Depicts		
attracted	pose	in heat, attraction, attarcted to someone		
bowing	pose	a bow, showing respect, bowing down		
catering	pose	serving dinner, providing food		
charming	pose	being charming, exuding charm		
composing	pose	composing music, playing music		
drinking	pose	drinking booze, drinking alcohol, having a drink, having a martini, enjoying a martini		
toasting	pose	making a toast, offering a toast, raising his glass		
embracing	pose	hugging, a bear hug, going in for a hug		
enchanting	pose	being enchanting, casting a spell, using magic, performing a miracle		
enticing	pose	being enticing, offering an enticement, bringing cake, offering cake, bearing gifts		
sweet	pose	bearing gifts, bringing dessert, serving dessert		
feeding	pose	nurturing a baby, feeding a child, being a nanny		
freeing	pose	setting free, breaking the chains		
guiding	pose	leading a guided tour, leading a tour group, showing the way		
handshaking	pose	shaking hands, going in for a handshake, offering a hand		
shaking hands	pose	shaking hands, going in for a handshake, offering a hand		
high fiving	pose	high fiving, going in for a high five
inspired	pose	being inspired, gaining inspiration, seeing the light, having an idea, solving a puzzle, finding the solution		
inspiring	pose	being an inspiration, inspiring others, showing the way, giving inspiration, being inspiring, 		
introducing flipped	pose	making an introduction		
introducing	pose	making an introduction		
joy	pose	filled with joy, jumping with joy, whooping with joy, bursting with joy		
kissing	pose	going in for a kiss, smooching, locking lips		
listening	pose	being a good listener, listening carefully, being attentive		
loving	pose	showing love, opening one's heart, offering one's heart, pledging love, being romantic		
massaging	pose	giving a massage, massaging tired muscles		
opening box	pose	opening a box, opening Pandora's box		
painting	pose	painting a picture, painting a portrait, making a work of art		
photographing	pose	taking a photo, taking a picture, snapping a picture, using a camera		
pitching	pose	throwing a pitch, throwing a ball, making a pitch		
batting	pose	wielding a bat, waving a bat, wielding a baseball bat, hitting a home run		
biting flower	pose	biting a flower, dancing romantically, doing a tango, dancing the tango		
praising	pose	offering praise, offering a compliment, using flattery, showing appreciation		
promoting	pose	offering a helping hand, giving a hand up, standing on a ladder, climbing the ladder		
purposeful	pose	going somewhere, following a goal, 		
recruiting	pose	recruiting followers, carrying a clipboard, gathering signatures		
stroking cat	pose	stroking a cat, concocting a plan, holding a kitten		
saluting	pose	offering a salute, saluting a superior officer, reporting for duty		
minion	pose	showing compliance, awaiting orders		
ironic	pose	being sarcastic, being ironic, using mockery, poking fun, hiding behind a mask, being a hypocrite		
sculpting	pose	sculpting a statue, carving a statue, sculpting stone, making a work of art		
serving	pose	serving dinner, working in McDonald'sworking in a fast food restaurant		
serving dinner	pose	serving dinner, providing food		
serving plate	pose	serving dinner, providing food		
stacking	pose	carrying plates, stacking plates, collecting dishes, stacking dishes		
piling	pose	stacking fruit, carrying fruit		
strong	pose	showing biceps, working out, showing off		
supporting	pose	offering support, showing support, giving moral support, being a loyal friend		
sympathetic	pose	showing sympathy, being sympathetic, offering a shoulder to cry on		
wooing	pose	wooing, offering one's heart, being romantic, proposing marriage		
patriotic	pose	carrying the flag, defending freedom, being a patriot, fighting for democracy		
signing	pose	signing a contract, signing a petition, holding a pen		
munching	pose	having a snack, snacking, eating cornflakes, eating breakfast, eating breakfast cereal 		
goading	pose	goading a bull, waving a red rag		
leaping	pose	leaping in the air, high jumping, jumping in the air, reaching for the sky		
tipping	pose	giving a tip, being a good tipper, offering a tip, being generous		
interviewing	pose	interviewing a celebrity, holding a microphone, reporting live from the scene, breaking a story		
breakfasting	pose	having breakfast, eating breakfast, eating breakfast cereal		
offering	pose	making an offering, performing a religious rite, performing a ritual, praying at an altar		
heroic	pose	being hero, being a hero, fighting heroically, standing up for justice, fighting for justice, wearing a cape		
rescuing	pose	rescuing a damsel, saving the day, swooping in to save the day, riding a white steed		
treating	pose	treating an ailment, offering treatment, diagnosing an ailment, filling a prescription, offering medicine		
knightly	pose	dedicating oneself to a cause, going down on bended knee		
ushering	pose	pointing the way, waving an umbrella, pointing with an umbrella		
imperious	pose	being imperious, issuing edicts, giving orders, being bossy, being a royal pain		
pointing	pose	pointing at the sky, looking up at the sky, pointing upwards		
pointing with umbrella	pose	pointing with an umbrella, waving an umbrella, pointing upwards		
droving	pose	leading a flock, being a shepherd, protecting the flock, herding sheep		
on soapbox	pose	standing on a soapbox, giving a speech, giving a lecture, lecturing to others, preaching to others, speaking in public		
negotiating for	pose	negotiating for another		
owed	pose	demanding payment, seeking payment, calling in a loan		
owing	pose	going into debt, going bankrupt, sinking into debt		
paying	pose	paying a debt, making a payment, depositing cash, making a deposit		
renting	pose	renting an apartment, getting the keys, holding keys		
hoarding	pose	hoarding gold, being a hoarder, being a miser, hiding wealth		
negotiating	pose	negotiating a deal, closing a deal, negotiating terms		
selling	pose	selling a product, making a sales pitch		
profiting	pose	profiting from a deal, making a profit, earning a windfall, making money		
rewarding	pose	offering a reward, giving a reward, rewarding loyalty		
blackbag	pose	peering into the abyss, holding a black bag, 		
blackmailing	pose	blackmailing a mark, engaging in blackmail, extorting a bribe,		
corrupting	pose	being a bad influence, offering a bribe, corrupting morals, engaging in corruption		
devious	pose	being devious, thinking wicked thoughts, plotting a wicked scheme, hatching a cunning plan		
luring	pose	luring innocents, baiting a trap, leading others astray		
mischievous	pose	being  mischievous, pulling a prank, being a brat, causing trouble, being irresponsible		
misleading	pose	leading others astray, being misleading, engaging in misdirection		
misrepresenting	pose	being a phony, acting in bad faith, being two-faced, being a hypocrite, engaging in deception		
snatching	pose	kidnapping an innocent, engaging in dirty tricks		
sneaky	pose	being sneaky, hatching a plot, hatching a conspiracy		
stalking	pose			
tracking	pose	following the trail, following a trail of bread crumbs		
snake charming	pose	charming a snake, charming a rattlesnake, selling snake oil		
manipulating	pose	manipulating others, being manipulative, masterminding a conspiracy		
gossiping about	pose	spreading gossip, telling tales, telling tall tales		
gossipy	pose	spreading gossip, telling tales, telling tall tales		
lying for	pose	telling lies, spreading lies, spreading propaganda		
cheating	pose	cheating at cards, playing cards, playing poker		
evaluating	pose	evaluating the situation, holding a clipboard, performing an analysis, fllling out a questionnaire		
gagged	pose	being gagged, taking a vow of silence, remaining silent, refusing to speak, being muzzled		
learning	pose	taking a test, sitting a test, completing a lesson		
philosophical	pose	being philosophical, thinking deep thoughts, thinking deeply, pondering the big questions		
philosophical with beard	pose	seeking ancient wisdom		
reading	pose	reading a book, reading a manual, enjoying a good book		
reading comics	pose	reading a comic, reading a comic strip, being a geek		
geeky	pose	being a geek, collecting comic books, playing with dolls		
shouting	pose	shouting loudly, ranting in public, delivering a harangue, making an announcement		
speaking	pose	speaking in public, holding a microphone, speaking into a microphone		
speaking for	pose	relaying a message		
whispering	pose	whispering in a low voice, sharing a secret, leaking an official secret, breaking a confidence		
thinking	pose	thinking out loud, worrying about life, thinking hard		
thinking with beard	pose	seeking ancient wisdom		
questioning	pose	asking questions, posing a riddle, pondering the situation, plagued by doubt		
indicating	pose	pointing the way, pointing the finger		
chronicling	pose	writing a chronicle, writing on a scroll, recording history		
lecturing	pose	giving a lecture, wagging the finger, delivering a sermon		
monitoring	pose	monitoring the situation, looking through a spyglass, using a telescope, looking through a telescope, looking on from afar		
tweeting	pose	sharing a tweet, using social media, updating their status		
interrogating	pose	interrogating a suspect, getting answers, cracking the whip		
examining	pose	holding a magnifying glass, examining the evidence		
probing	pose	holding a magnifying glass, examining the scene		
foretelling	pose	telling the future, forecasting the future, using a crystal ball		
one	pose			
two	pose			
three	pose			
four	pose			
five	pose			
six	pose			
seven	pose			
eight	pose			
nine	pose			
breakfasting flipped	pose	having breakfast, eating breakfast, eating breakfast cereal		
zero	pose	zero points		
one flipped	pose			
two flipped	pose			
three flipped	pose			
four flipped	pose			
five flipped	pose			
six flipped	pose			
seven flipped	pose			
eight flipped	pose			
nine flipped	pose			
zero flipped	pose			
kneeling	pose	kneeling down, bowing deeply, begging foregiveness		
campaigning	pose	running a campaign, campaigning for change, handing out leaflets, distributing pamphlets		
voting for	pose	voting for a candidate, voting yes, casting a vote		
commanding	pose	giving commands, commanding a junior officer, giving orders		
directing	pose	directing a movie, shouting action		
leading	pose	leading a flock, herding sheep, guiding the flock		
leading with beard	pose	guiding the flock, spreading the good word		
ruling	pose	ruling with impunity, issuing edicts, issuing a royal decree		
brainwashing	pose	brainwashing a subject, being a control freak, using mind control, running a cult		
conquering	pose	conquering an enemy, vanquishing an opponent, declaring victory		
campaigning against	pose	running a negative campaign, campaigning against the encumbent		
radicalizing	pose	radicalizing a zealot, launching a religious crusade, declaring a fatwa		
voting against	pose	casting a NO vote, voting against the proposition		
worried	pose	expressing worry, worrying about a problem, reacting nervously		
suicidal	pose	committing suicide, contemplating suicide, succumbing to fatalism		
persian urn prop	prop			
grecian urn prop	prop			
sharktank prop	prop			
cerberus prop	prop			
whirlwind	pose			
chimera prop	prop			
ghost prop	prop			
grim reaper prop	prop			
skeleton prop	prop			
wolf howling prop	prop			
wolf prop	prop			
lion roaring prop	prop			
lion prop	prop			
panther roaring prop	prop			
panther prop	prop			
tiger roaring prop	prop			
dog prop	prop			
monolith prop	prop			
timebomb prop	prop			
penguin prop	prop			
bull prop	prop			
sundae prop	prop			
meteor prop	prop			
cow prop	prop			
brundlefly prop	prop			
golden cat prop	prop			
silverback prop	prop			
frozen dinosaur prop	prop			
spider prop	prop			
wasps prop	prop			
cerberus eating prop	prop			
clock prop	prop			
mouse prop	prop			
stephen hawking	figure			
horse prop	prop			
brown horse prop	prop			
donkey prop	prop			
pigface prop	prop			
killing for	pose	going on a killing spree		
shooting	pose	shhoting a gun, waving a gun, pointing a gun		
writing	pose	writing a letter, using a tablet		
accusing	pose	making accusations, pointing the finger of blame, threatening legal consequences		
angry	pose	expressing anger, reacting angrily, angrily shaking a fist 		
arresting	pose	arresting a suspect, putting someone under arrest		
attacking	pose	launching an attack, attacking an enemy, brandishing a knife, stabbing wildly		
banishing	pose	expelling a miscreant, saying good riddance		
biting	pose	baring one's teeth, snarling menacingly, going for the jugular		
bullying	pose	being a bully, charging like a bull, charging angrily		
casting off	pose	breaking the chain, freeing oneself from bondage, casting off a heavy chain		
charging	pose	charging in, charging angrily, reacting angrily		
cold shoulder	pose	giving the cold shoulder, showing no interest, being indifferent, affecting disdain		
condescending	pose	being condescending, rolling one's eyes, adopting a patronizing attitude		
critical	pose	being critical, expressing criticism, giving the thumbs down, expressing disapproval		
critical about	pose	being critical, expressing criticism, giving the thumbs down, expressing disapproval		
decapitating	pose	wielding a giant axe, going in for the kill, reacting violently		
defensive	pose	adopting a defensive attitude, being defensive, fearing the worst, reacting with shock, backing down		
defiant	pose	expressing defiance, putting up resistence, refusing to back down, resisting defiantly, shaking their fists		
denouncing	pose	denouncing a rival, burning with rage, inflamed with anger, declaring war, pushing the hardline		
destructive	pose	being destructive, causing destruction, wielding a giant hammer, crushing the opposition, delivering an onslaught of violence		
disagreeing	pose	openly disagreeing, expressing skepticism, holding out		
disgusted	pose	expressing disgust, reacting with disgust, refusing to agree		
eluding	pose	eluding capture, hiding out, keeping a low profile		
escaping	pose	making a break for it, escaping from captivity, getting out of jail, breaking free		
fighting	pose	putting up a fight, reacting with aggression, threatening violence		
fighting with beard	pose			
haughty	pose	winning the championship, declaring victory, crowing triumphantly		
hiding	pose	hiding out, cowering in fear		
hindering	pose	being a hindrance, saying no, refusing to join		
hitting	pose	lashing out, throwing a punch, starting a fight		
slapping	pose	lashing out, slapping down a rival		
staking	pose	staking a vampire, slaying a demon		
poking	pose	pointing the finger, pointing the finger of blame		
kicking	pose	kicking like a mule, throwing a karate kick, doing kung fu		
hunting	pose	hunting prey, leading a search party, leading a pack of dogs		
indifferent	pose	expressing indifference, showing no interest, showing a deaf ear		
pushing	pose	rushing in, pushing aggressively		
rebellious	pose	being a rebel, launching a rebellion, playing with fire, playing with matches		
rent an angry mob	pose	rabble rousing, leading an angry mob		
running away	pose	running away, fleeing the scene, making a hasty retreat		
running off	pose	beating a hasty retreat, running off		
satirizing	pose	poking fun, telling a joke, engaging in mockery		
savaging	pose	savaging a rival, attacking with knives, reacting fiercely		
scary	pose	laughing demonically, telling a scary story, frightening the innocent, preying on the innocent		
stabbing	pose	attacking with a knife, stabbing wildly		
starving	pose	enforcing a strict diet, denying comfort, wasting food		
suspecting	pose	developing suspicions, detecting a rat, finding a rat, smelling a rat 		
targeting	pose	shooting an arrow, wielding a bow and arrow, aiming for the target		
threatening	pose	making threats, brandishing a knife, threatening violence		
unleashing	pose	unleashing a wild dog, letting slip the dogs of war		
withholding	pose	refusing payment, refusing to pay up, witholding payment		
holding nose	pose	suffering from a head cold, blowing one's nose, covering one's nose, smelling a stink		
blocking	pose	expressing dissent, refusing to back down, blocking the way		
fainting	pose	fainting, falling into a coma, fainting with fear		
frowning	pose	frowning with disappointment, expressing disappointment, reacting to bad news		
put out	pose	making an offer, making a suggestion, cutting to the chase		
shielding behind umbrella	pose	shielding behind an umbrella, taking cover behind an umbrella		
covering eyes	pose	covering one's eyes, refusing to look, blocking out the sight		
punching	pose	throwing a punch, starting a fight		
plugging ears	pose	plugging one's ears, refusing to listen, blocking out the sound		
slinging mud	pose	throwing mud, hurling abuse, launching a smear campaign		
discarding book	pose	discarding a book, throwing the book away		
vomiting	pose	vomiting, getting sick, throwing up		
lunging	pose	lunging with a sword		
siccing	pose	leading the attack, siccing dogs, rabble rousing		
swallowing	pose	reacting with distaste, reacting with skepticism, swallowing a bitter pill		
betraying	pose	betraying a friend, being corrupted, going over to the dark side, conspiring with snakes		
sniping	pose	lining up the target, preparing to shoot, lining up a shot, brandishing a rifle		
judging	pose	delivering a judgment, delivering a verdict, rendering judgment		
scolding	pose	scolding a naughty child, wagging the finger		
smug	pose	being smug, reacting with pride, exuding arrogance		
deceptive	pose	telling a lie, plotting a deception, hatching a devious plan, running a confidence trick		
suspicious	pose	behaving suspiciously, launching a cover up, covering up a crime, hiding a skeleton in the closet		
silencing	pose	demanding silence, silencing a critic		
oppressing	pose	running a totalitarian regime, crushing dissent, crushing the enemy		
troublemaking	pose	causing trouble, making trouble, playing with fire, playing with matches, playing with dynamite 		
pouncing dog	prop			
baying hound	prop			
hunting dog	prop			
pack of hounds	prop			
killing	pose	going on a killing spree, mugging a tourist, demanding money with menaces, threatening violence, threatening murder		
mugging	pose	mugging a tourist, demanding money with menaces		
stealing	pose	stealing money, committing a robbery, running off with the loot		
terrorizing	pose	launching a campaign of terror, lighting the fuse, throwing a bomb, declaring war, starting a jihad		
whipping	pose	cracking the whip, wielding a whip, lashing out		
excommunicating	pose	banishing an infidel, preaching to a sinner		
exorcising	pose	exorcising a demon, banishing a demon		
taunting	pose	being rude, being vulgar, using vulgar language, taunting a rival		
spitting	pose	spitting with disgust, expressing disgust, spitting on the ground, spitting out something unpalatable, showing disdain by spitting, reacting with disdain		
haunting	pose	rising from the dead, haunting a graveyard		
avenging angel	pose	seeking vengeance, looking for revenge, demanding justice		
crucified	pose	nailed to a cross, dying for their beliefs		
blessing	pose	offering a blessing, saying a prayer, preaching the good word		
blessing with beard	pose			
praying	pose	saying a prayer, praying to the lord		
angelic	pose	being an angel, flying high, flying on angel's wings		
saintly	pose	wearing a halo, behaving like a saint, virtue signalling		
worshipped	pose	being worshipped like a god, standing on a pedestal, nurturing a god complex		
exorcised	pose	giving up the ghost, being scared shitless, being scared to death		
preachy	pose	delivering a sermon, preaching to a sinner, reciting the gospel		
sacrificing	pose	offering up a sacrifice, sacrificing a lamb, performing a blood sacrifice, slaughtering a lamb		
blaspheming	pose	uttering a blasphemy, blaspheming against God, boiling with rage, going into a berserker rage, being consumed with rage		
demonic	pose	spreading darkness, raising hell, worshipping the devil, going over to the dark side		
experimenting	pose	conducting an experiment, experimenting on humans, testing an experimental drug, drawing blood		
operating	pose	performing surgery, waving a scalpel		
stargazing	pose	gazing at the stars, looking through a telescope, watching the skies, scanning the night sky, looking for extraterrestrial life		
foreboding	pose	dreading the future, worrying about tomorrow, fearing the worst, preparing for rain, expecting a storm		
airport	setting	an airport		
art studio	setting	an art studio, an atelier, an artist's studio		
balcony	setting	a courtyard with a balcony		
bank exterior	setting	exterior view of a bank		
bank	setting	bank interior with cashier		
bar	setting	tavern or pub		
bedroom	setting	a bedroom, a boudoir, a dormitory		
battlefield	setting	a battle field, a war zone, a desolate wasteland, a ruined city		
blizzard	setting	a blizzard, a snow storm, arctic conditions		
boat dock	setting	a boat dock, a boat yard, a pier		
boneyard	setting	a desolate cave, a bone yard, a pirate cave, a dungeon		
boulevard	setting	a tree-lined boulevard		
building site	setting	a building site, a construction site		
campaign trail	setting	a lectern, a debate stage, a dias, a press conference		
cave rocks	setting	a rocky cave, a rocky landscape		
cave	setting	a dark cave, an underground cavern		
changing room	setting	a changing room		
church	setting	a church interior, a chapel, an altar		
city gates	setting	the city gates, castle gates, a portcullis		
courthouse	setting	the courthouse steps		
cliff edge	setting	the cliff edge, a rocky promontory		
courthouse exterior	setting	a courthouse, the supreme court, a court of law		
clouds	setting	a cloudy sky		
comedy club	setting	a comedy club		
courtyard	setting	a leafy courtyard		
dark city	setting	a dark city, a mysterious city, a city in the gloom		
dark forest	setting	a dark forest, a creepy forest		
dawn of man	setting	a barren landscape		
debate stage	setting	a debate stage		
distant volcano	setting	a distant volcano, an erupting volcano, a shower of lava and smoke		
desert	setting	the desert sun, a parched desert		
drawbridge	setting	a castle drawbridge		
drawing board	setting	an office with a drawing board		
dungeon	setting	a bleak dungeon		
embankment	setting	a steep rocky embankment		
farm	setting	a wind farm, a field of wind turbines, green energy		
factory	setting	a factory, an assembly floor		
foothills	setting	the base of a mountain, rocky foothills		
forest path	setting	a path through the forest		
forest trail	setting	a forest trail, a path to a dark forest		
forked path	setting	a fork in the path		
forest	setting	a mountain surrounded by trees		
forge	setting	a blacksmith's forge		
gravel path	setting	a gravel path, a stony path, crazy paving		
government	setting	government buildings, the congress, a parliament		
gates of hell	setting	the gates of hell, Hades, eternal damnation		
frozen in ice	setting	a block of ice, an ice house		
graveyard	setting	a graveyard, a cemetary, tombstones		
graveyard with walls	setting	a walled graveyard, a secluded graveyard		
guillotine	setting	the guillotine, the French revolution		
haunted house	setting	a haunted house		
gym	setting	a gym, a gymasium, a workout room		
hospital	setting	hospital interior, a hospital ward		
hospital exterior	setting	hospital exterior		
high windows exterior	setting	exterior wall with windows		
high windows interior	setting	interior wall with windows		
hotel	setting	a hotel, a five-star hotel		
interview room	setting	an interview room, a meeting room		
lava	setting	fire and brimstone, an erupting volcano, the end of the world, chaos		
iron throne	setting	the iron throne, the throne room		
kitchen	setting	a kitchen, a kitchen counter		
laboratory	setting	a laboratory, a secret laboratory		
laundrette	setting	a laundrette		
library	setting	a library		
lighthouse	setting	a  lighthouse, a lighthouse surrounded by high waves		
lightning	setting	a lightning storm		
low trench	setting	a trench in a muddy field		
luggage belt	setting	an airport luggage belt		
marshlands with bodies	setting	a bog filled with dead bodies, a battlefield strewn with corpses		
marshlands	setting	a marshland, a quagmire		
mordor	setting	bleakest Mordor, the eye of Sauron		
mountain pass	setting	a mountain pass, a mountain road		
airplane interior	setting	an airplane interior		
apocalypse	setting	the end of the world, a post-apocalyptic landscape		
mountain trail	setting	a mountain trail, a rocky trail		
mountain trees	setting	trees on the mountain		
mountain view	setting	a snow-capped mountain		
mud and rats	setting	a muddy bog, a muddy wasteland		
muddy rubbish dump	setting	a muddy rubbish dump, a rubbish dump, an open sewer		
nightsky	setting	the sky at night, a moonlit landscape		
north by northwest	setting	Mount Rushmore		
ocean	setting	a tsunami, an ocean wave		
office 2	setting	an office with water cooler and filing cabinet		
office	setting	an office with water cooler		
open city gates	setting	the open gates of an ancient city		
park bench	setting	a park bench on a sunny day		
park night	setting	the park on a moonlit night		
police lineup	setting	a police lineup		
police state	setting	a totalitarian regime, a fascist regime		
police station	setting	a police station exterior		
polling station	setting	a polling station, a polling booth		
prison	setting	a prison topped with barbed wire		
rain and clouds	setting	a cloudy and rainy day		
rain	setting	a rainy day		
rainbow	setting	a rainbow in the park		
restaurant exterior	setting	a restaurant patio		
rainy forest	setting	a forest on a rainy day		
restaurant	setting	a restaurant and bar		
river of blood	setting	a river of blood		
rocks and sky	setting	rocks against  blue sky		
rocky path	setting	a rock-strewn path		
rubbish dump	setting	a rubbish dump with crows and vermin		
salon	setting	a hair salon, a beauty parlour		
sports field	setting	a sports field		
stage curtains	setting	a theatre stage		
stalactite	setting	a dark cave with stalactites		
statue	setting	a statue in the park, pigeons crapping on a statue in the park		
stone stairs	setting	stone stairs leading down to a dungeon		
sun and clouds	setting	the sun peeking through the clouds 		
swamp gas	setting	a dark and dank swamp		
swamp hollow	setting	a swamp hollow		
swamp	setting	a swamp with aligators		
toilet	setting	a public restroom		
tornado	setting	a tornado causing havoc		
tower base	setting	the base of a tower		
tower in distance	setting	a landscape with a mysterious tower in the distance		
tower in swamp	setting	a tower in a dank swamp		
tower tops	setting	the cloud-shrouded spires of a city of towers		
tower	setting	a red tower against a blue sky		
trees	setting	a forest of densely-packed trees		
trench	setting	a deep trench in a muddy field		
university	setting	a university campus, a red-brick university, a leafy university campus		
valley	setting	a leafy valley in autumn		
volcano	setting	an erupting volcano spewing lava and hot gas		
wall daylight	setting	an exterior wall in daylight		
wall night	setting	an exterior wall at night		
welcome mat	setting	a suburban front door with welcome mat		
window cityview	setting	a living room window		
window interior	setting	a living room		
winners podium	setting	the winner's podium, the winner's circle		
winter	setting	snow-covered trees in winter		
war of the worlds	setting	an alien invasion, a nighttime invasion by aliens		
open road	setting	the open road		
superstore	setting	a superstore, a supermarket		
moonscape	setting	the surface of the moon, a lunar landscape, a lunar landscape pocked with craters		
earthrise	setting	the Earth rising above a rocky lunar landscape		
another world	setting	an alien world, nightfall on an alien world		
garden party	setting	a garden party, a summer party in the garden		
outdoors night	setting	a dark cityscape at night		
attic	setting	a dark and dusty attic		
extinction	setting	meteors falling on a landscape of dinosaurs, the age of the dinosaur		
beach party	setting	a party on the beach, the restaurant at the end of the world		
shanghai	setting	Shanghai, the Pearl tower		
australia	setting	Ayers rock, the Australian outback		
sydney	setting	Sydney opera house		
frankfurt	setting	Frankfurt town centre, a European town centre		
wellington	setting	Wellington New Zealand		
new zealand	setting	a glacier surrounded by grassy mountain tops		
spain	setting	a Spanish hacienda		
korea	setting	A Korean temple		
lisbon	setting	A tram on a Lisbon street		
mumbai	setting	Bombay harbour		
delhi	setting	A red fort in New Delhi		
taj mahal	setting	the Taj Mahal		
naples	setting	A side street in Naples, an alley way		
rome	setting	the colosseum, the Roman colosseum		
montreal	setting	a Montreal street		
canada	setting	the Canadian wilderness, snow-capped mountains and a crystal lake		
hollywood	setting	the Hollywood hills		
beijing	setting	the great wall of China		
gobi desert	setting	the Gobi desert, a sun-baked desert		
parthenon	setting	the Parthenon in Athens, ancient democracy, Ancient Greece, the Ancient world		
south pole	setting	the South Pole, penguins on melting ice floes, melting icebergs		
north pole	setting	the North Polem snow falling in the North Pole, snow falling on an ice field		
northern lights	setting	the Northern Lights		
london	setting	London Bridge		
ireland	setting	a castle on a hill in Ireland, a field of sheep in Ireland, a field of sheep and a ruined castle, a ruined monastery		
tokyo	setting	Tokyo bay and Mount Fuji		
rio	setting	Rio de Janeiro		
table mountain	setting	Table mountain in South Africa		
brandenburg gate	setting	the Brandenburg gate, checkpoint Charlie		
new york	setting	the Brooklyn bridge, New York city		
manhattan	setting	the Manhattan skyline		
california	setting	a beach in California		
florida	setting	a beach in Florida, the Florida keys, a sunny beach with palm trees		
texas	setting	an arid field with cactuses, rural Texas		
vienna	setting	a cathedral in Vienna, a cathedral		
red square	setting	Red Square in Moscow, the Kremlin		
pisa	setting	the leaning tower of Pisa		
paris	setting	the Eiffel tower, a view of Paris, a romantic view of Paris		
hawaii	setting	a beach in Hawaii		
dublin	setting	an iron gate in Dublin, the Guinness brewery		
seattle	setting	the Seattle skyline		
united nations	setting	the United Nations, the United Nations building in New York		
africa	setting	the savannah in Africa, an African landscape		
israel	setting	the temple on the mount, Jerusalem, Israel		
amazon	setting	an Amazon fulfillment centre, a warehouse		
crypto	setting	cyberspace, a bank vault		
scotland	setting	a castle in Scotland, a castle on a hill		
indonesia	setting	a Khmer temple in Indonesia, Angor Wat, a temple in Cambodia, a temple in Thailand		
mexico	setting	a Mayan pyramid, a Mexican pyramid, ancient Mexico, a Mayan temple		
wales	setting	a grassy landscape, a field in Wales		
argentina	setting	the pampas in Argentina, a grassy field of sheep and cows		
jamaica	setting	a beach in Jamaica		
vietnam	setting	a bay in Viet Nam, the South China sea		
switzerland	setting	ski chalets in Switzerland		
wallstreet	setting	Wall Street, the business district		
islam	setting	a Muslim temple, Islamic architecture		
sweden	setting	old world charm, old European houses		
pakistan	setting	a Muslim temple, Islamic architecture		
netherlands	setting	windmills on the canal, the Dutch countryside		
scotus	setting	the Supreme court		
europe	setting	European tourism, European architecture		
server farm	setting	a server farm, a room full of computers		
newsroom	setting	a television newsroom, a TV station		
singapore	setting	modern architecture, the Singapore skyline		
shop window	setting	a shop window, a clothes shop		
arizona	setting	a barren landscape, a barren landscape in Arizona, the wild west		
syria	setting	a ruined building in a war zone		
chemical plant	setting	a chemical plant, chimneys belching smoke into the air, factory chimneys		
favela	setting	a favela in Brazil, a slum		
petronas	setting	the Petronas towers		
thailand	setting	a beach in Thailand, a beach in Asia		
suburbs	setting	a quiet suburban street		
slum	setting	a slum, a ghetto		
egypt	setting	the pyramids of Giza, pyramids in the desert		
iceland	setting	a town in iceland, a town and a glacier		
waterfall	setting	a waterfall		
dam	setting	a dam		
brussels	setting	the Atomium in Brussels, modern art		
vatican	setting	the Vatican, the Vatican in Rome		
maralago	setting	Mar-a-Lago, a golf club in Florida		
deathstar interior	setting	inside the Deathstar		
cdc	setting	the CDC building in Atlanta		
colombia	setting	a Spanish hacienda, a Spanish-style monastery		
philadelphia	setting	Philadelphia, the city of brotherly love		
philippines	setting	a shanty town, a shack in the Philippines		
taiwan	setting	a skyscraper towering over a city, a skyscraper in Taiwan 		
libya	setting	a ruined building in a war zone, a ruined building in Libya		
cuba	setting	a street in Havana		
bosnia	setting	a bridge in Bosnia, an ancient bridge		
rwanda	setting	dense grassland in Africa, grasslands in Rwanda		
ukraine	setting	a battlefield in Ukraine		
lebanon	setting	a scene of devastation, downtown Lebanon		
haiti	setting	a shanty town, a shack in Haiti		
poland	setting	a Polish village,a traditional village,a Potemkin village		
mongolia	setting	camels in the desert, outer Mongolia		
estonia	setting	an traditional European village, a traditional European town, an Estonian town		
car factory	setting	a car factory, a Tesla factory		
train station	setting	a train station, a train at a plaform		
secret bunker	setting	a secret underground bunker, a secret lair		
statue of liberty	setting	the Statue of Liberty, the New York skyline, a symbol of democracy		
barcelona	setting	Barcelona, Gaudi's cathedral		
oil well	setting	an oil well, an oil well gushing oil		
coal mine	setting	a coal mine		
launchpad	setting	a rocket blasting off, a shuttle on the launchpad, a launchpad at Cape Canaveral		
nuclear plant	setting	a nuclear power plant, a power plant, a power plant belching smoke into the sky, Chernobyl		
city of towers	setting	an ancient city of gleaming towers		
new orleans	setting	the French Quarter in New Orleans		
chicago	setting	Chicago		
idaho	setting	Idaho, a farm in Idaho		
ohio	setting	the Ohio skyline		
alaska	setting	snow-capped mountains reflected in crystal-clear waters		
michigan	setting	downtown Michigan, a small town		
colorado	setting	a snowy town in colorado		
wisconsin	setting	a leaf-strewn rod in Wisconsin		
iowa	setting	a rural farm in Iowa, a remote farm		
buffalo	setting	a government building, a civic administration building		
georgia	setting	a gothic mansion, a mansion in a swamp		
utah	setting	a rocky outcrop, a rock formation in Utah		
nebraska	setting	a herd of cattle on the trail		
kansas	setting	a rural farm in Kansas, a farm with a white picket fence		
oklahoma	setting	a windmill in Oklahoma, a remote farm in Oklahoma		
las vegas	setting	the Las Vegas strip, a casino town, sin city		
maine	setting	a lighthouse in Maine, a lighthouse on a rocky outcrop		
baltimore	setting	a row of period houses		
providence	setting	an empty street downtown, a quiet downtown area		
fresno	setting	downtown at twilight		
connecticut	setting	a leafy suburb		
pentagon	setting	the pentagon, military headquarters		
alabama	setting	a stately Southern manor		
new jersey	setting	a watertower in the suburbs 		
minnesota	setting	the Minnesota skyline, a bustling city		
harvard	setting	a leafy college campus, a red-brick university campus, an Ivy League college		
wyoming	setting	rural Wyoming, Devils Tower in Wyoming		
kentucky	setting	a sleepy farm in Kentucky		
berkeley	setting	a leafy college campus, a college campus in the fall		
virginia	setting	a colonial-style house		
yosemite	setting	Yosemite national park, El Capitan in Yosemite		
arkansas	setting	a lush forest overlooking a river		
springfield	setting	Moe's Tavern, a dive bar in Springfield		
wellesley	setting	an Ivy Leage college in the fall		
argentina	setting	the pampas in Argentina, a grassy field of sheep and cows		
cambridge	setting	a college on the river with rowboats		
oxford	setting	Oxford university, an old-fashioned university		
boston	setting	downtown Boston, a patriotic monument in a city park		
wind farm	setting	a wind farm, a field full of wind turbines		
above florence	setting	the Duomo in Florence, the piazze del Duomo		
sistine ceiling	setting	the Sistine ceiling		
columbia	setting	a leafy college campus, a college campus in the fall		
castle walls	setting	a castle moat with a drawbridge		
castle in valley	setting	castle walls in a valley		
banks of the Styx	setting	the banks of the river Styx		
black water	setting	a river of dark water, the dark waters of the Styx		
rubbish on river bank	setting	a river bank strewn with rubbish		
disgusting	pose	behaving in a disgusting fashion, doing something disgusting, being disgusting		
arrested	pose	surrending to the police, under arrest		
begging	pose	pleading on one's knees, reduced to begging		
bowling	pose	rolling a strike, going bowling		
brainwashed	pose	in a trance, stumbling about in a trance, being hypnotised, walking in one's sleep, sleepwalking		
building	pose	laying bricks, building a wall, building a brick wall		
carrying	pose	carrying a box, carrying boxes		
carrying for	pose	delivering a package, delivering packages		
carrying bowl	pose	holding a punch bowl, serving punch at a party		
carrying fishbowl	pose	carrying a fishbowl, carrying a goldfish bowl, caaring for a goldfish		
chained	pose	straining against shackles and heavy chains		
challenging	pose	laying down the gauntlet, issuing a challenge, challenging a rival		
charmed	pose	feeling utterly charmed, feeling as if under a spell		
childish	pose	behaving childishly, feeling like a little child again, reliving one's childhood, playing with childish things		
infantile	pose	behaving like a baby, acting as innocent as a newborn child		
cleaning	pose	cleaning and scrubbing with soap and suds and water		
slopping	pose	slopping out a bucket of waste, carrying a bucket of water		
picnicking	pose	going to a picnic, carrying a basket of fruit, coming back from a farmer's market		
leaking	pose	carrying a leaky bucket of water, spilling water from a leaky bucket, leaking water everywhere		
committing	pose	committing to a cause, dedicating oneself to a noble cause, offering to fight for a noble cause		
golfing	pose	playing golf, teeing off at the golf course, putting a ball on the golf course, swinging a golf club		
competing	pose	kicking a football, playing a competitive sport, playing soccer, running up the field with the ball		
competing for	pose	running away with the ball, kicking a football back down the field		
competing with	pose	jumping into the fray, leaping into action		
confident	pose	striking a confident pose, exuding confidence, looking to the future with confidence		
confused	pose	confused and wary about the future, feeling confused about what just happened, feeling confused and unsure what to do next		
cooking	pose	holding a mixing bowl and a wooden spoon, making brownies with a wooden spoon, wearing a chef's hat		
cutting bread	pose	slicing a loaf of bread with a sharp knife, making a sandwich from some bread		
cutting the cheese	pose	cutting a block of cheese with a sharp knife		
creating	pose	offering ideas and clever suggestions, bursting with ideas and suggestions		
mounting bicycle	pose	getting on to a bicycle, preparing to go for a bicycle ride		
dismounting bicycle	pose	getting off a bicycle, coming back from a bicycle ride		
cycling	pose	riding a bicycle		
motorcycling	pose	riding a motorbike		
dead	pose	hiding behind a gravestone, watching a revenant rise from the dead, shaking with fear in a graveyard, contemplating death		
defending	pose	guarding the citadel with a rifle, standing to attention with a rifle, defending democracy with a rifle		
depressed	pose	feeling depressed and under a dark cloud, living under a dark cloud, suffering from depression		
designing	pose	holding a blueprint for a new product, putting a new idea into practice, proudly showing the blueprint for a better lightbulb		
disappointed	pose	feeling disappointed, lacking confidence and direction, feeling lost and unsure of oneself		
skunk	pose	stinking of poo, stinking like a skunk		
elephant	pose	supporting the Republican party, campaigning for the Republican nomination, dressed as an elephant		
dispatched	pose	going on an important mission, delivering an important message		
dressing	pose	getting dressed, choosing what clothes to wear, reorganizing the clothes in a wardrobe		
drinking coffee	pose	drinking a cup of coffee, drinking coffee and eating a donut		
driving	pose	driving a car, holding the steering wheel of a car		
dying	pose	crying at the grave of a loved one, mourning the loss of a loved one, begging for one's life at a grave, coming to term's with death		
embarrassed	pose	feeling embarrassed, feeling exposed, feeling humiliated		
expelled	pose	leaving with a suitcase and a bad attitude, angrily leaving town with a suitcase, angrily moving on		
exploding	pose	exploding in a puff of smoke and a ball of fire, stepping on a landmine, being blown sky high		
falling	pose	falling backwards, taking a sudden tumble, stumbling and falling, getting knocked backwards		
standing on head	pose	standing on one's head, doing a headstand, doing cartwheels		
farming	pose	taking a prize pig to market, walking with a pig		
farting	pose	farting loudly, breaking wind, suffering from a bad case of indigestion		
fighting with	pose	running off to do battle, running headlong into the fray, running headlong into battle with fists swinging		
goofy	pose	acting the fool, playing the fool, goofing around, fooling around		
hungry	pose	preparing to eat, salivating at the prospect of food, hungrily waving a knife and fork, tucking into a large meal with knife and fork, salivating at the thought of a juicy meal		
imitating	pose	hiding behind a mask, pretending to be someone else, dressing up as someone else, doing an impression of someone		
impressed	pose	feeling in awe of someone, reacting with awe and feeling impressed		
imprisoned	pose	feeling confined and imprisoned, imprisoned behind bars, rotting in jail		
juggling	pose	juggling balls, performing a party trick, being the life of the party, entertaining others		
squirting	pose	squirting water from a toy pistol, making a mess with a water pistol, spraying water from a squirt gun		
laughing	pose	laughing heartily, pointing and laughing mockingly, mocking another by pointing and laughing		
lawyer	pose	holding a briefcase and money, negotiating a backroom deal, cutting a business deal, making a plea deal		
neutral	pose	passing the time of day		
overshadowed	pose	feeling overshadowed		
passing telephone	pose	experiencing shock and awe, reeling with shock, feeling overcome with awe		
pleading	pose	pleading on one's knees, reduced to begging, pleading for mercy, pulling on the heartstrings		
posing	pose	posing for a photo, posing for a portrait, posing for a selfie		
preying	pose	preying on the innocent, scaring the life out of someone, preparing to pounce on a victim, hunting for a victim		
examining document	pose	examining a document, examining paperwork, examining a document with a magnifying glass		
reading newspaper	pose	reading the newspaper, catching up with the news		
reading magazine	pose	reading a magazine		
rejected	pose	feeling rejected and alone, feeling abandoned, feeling like an outcast		
riding	pose	riding a horse, galloping into the fray, arriving on horseback, competing in a horse race		
rude	pose	being vulgar and rude, using lewd gestures and foul language, angrily using lewd gestures and bad language		
running	pose	running into the fray, running to the scene		
sad	pose	feeling sad and tearful, bursting out crying, weeping and wailing, crying like a baby		
scared	pose	feeling scared, feeling terrified, shaking with terror		
searching	pose	searching with a flashlight, exploring with a flashlight, peering into the gloom with a flashlight		
shilling	pose	campaigning for a favored candidate, handing out pamphlets for a candidate		
screaming	pose	screaming and shouting, screaming at the top of one's lungs, letting out a sharp howl, howling like a spoilt brat, howling like a scalded cat		
sick	pose	feeling sick and helpless, being confined to a wheelchair, struggling with a wheelchair		
singing	pose	singing a song of joy, singing karaoke, singing into a microphone		
sipping	pose	sipping a martini, making small talk at a cocktail party		
smitten	pose	overcome with love, falling in love, falling head over heels in love		
smoking cigar	pose	smoking a big cigar		
space cadet	pose	taking one giant leap for mankind, planting the flag on an alien world, boldly going where no man has gone before, wearing a space suit and carrying a flag		
slicing	pose	holding a sharp knife and a Swiss army knife, comparing knives		
styling	pose	cutting hair, working in a hair salon, styling hair with scissors and blowdryer, holding a pair of scissors and a blowdryer		
summoning	pose	issuing a royal summons, summoning a subject to an audience with the monarch		
alarmed	pose	feeling shocked and alarmed, reacting with shock and awe		
surprised	pose	feeling surprised, reacting with surprise		
swimming	pose	going for a swim, swimming in water		
telephoning	pose	answering the telephone, speaking on the telephone		
blasting	pose	unleashing terror, bursting with anger, unleashing immense destructive power, hurling thunderbolts		
toppled	pose	being toppled from power, being knocked off one's perch, losing one's position of power, falling from power		
towering	pose	towering over others, feeling on top of the world, rising to a great height		
training	pose	working out with weights, training with weights, sweatily lifting weights		
transported	pose	being transported, being a backseat driver, being taken for a ride		
transporting	pose	sitting in the driver's seat, driving away in a vehicle		
unaware	pose	having the strange feeling of being watched, having the feeling of being followed, having to watch one's back		
walking a dog	pose	walking a dog, taking a dog for a walk		
unwary	pose	walking into a trap, stepping on a bear trap, walking into danger, making the wrong decision 		
visiting	pose	arriving with a suitcase, carrying a suitcase, coming on vacation		
stranger	pose	arriving with a suitcase and an air of mystery		
walking away	pose	walking away purposefully, exiting stage left		
working	pose	working in an office, sweating over the bureacracy in an office, sweating next to a filing cabinet 		
wounded	pose	suffering an injury, suffering a head injury, wailing in pain		
cowering	pose	cowering in fear amongst the rats		
popping pills	pose	popping pills, swallowing pills, abusing drugs		
gimp	pose	wearing black leather and chains, getting dressed as a gimp		
thoughtful	pose	thinking carefully about what just happened, thinking carefully about what to do next		
rising from coffin	pose	rising from the dead, rising from a coffin, emerging from a coffin		
on fire	pose	catching on fire and running in panic, suddenly bursting into flame 		
gorgon	pose	turning people to stone with a horrific gaze, scaring people with a head full of snakes, becoming a complete gorgon		
insisting	pose	insisting on a point, making a point, insistently pointing and debating		
pushing a rock	pose	pushing a giant rock		
lying down	pose	lying down		
holding umbrella	pose	holding an umbrella, holding an umbrella and pointing		
introducing oneself	pose	introducing oneself		
using umbrella	pose	using an umbrella, using an umbrella to shelter from the rain		
shielding with umbrella	pose	shielding from the elements with an umbrella		
eating	pose	eating a hamburger, eating fast food, enjoying a burger		
eating grapes	pose	eating grapes, eating bunches of grapes		
aching	pose	taking a pain killer to relieve an ache		
digging deeper	pose	asking a pertinent question, making a reasoned argument		
shrugging	pose	reacting with disbelief, shrugging with indifference, expressing skepticism		
recollecting	pose	recollecting the past, thinking about the consequences of a decision, coming to a reasoned decision, considering all of the evidence		
blind warrior	pose	stumbling with a sword		
blind warrior with beard	pose			
unconscious	pose	falling unconscious, falling into a coma, blacking out on the floor		
spraying bugs	pose	spraying insects with bug killer, spraying bugs with an aerosol		
chased by mosquitos	pose	being chased by mosquitos, running from mosquitos		
chased by wasps	pose	being chased by wasps, running from wasps, getting stung by wasps, getting stung by bees, being chased by bees, kicking a hornet's nest		
waving flag	pose	waving the flag, waving the white flag		
slogging	pose	slogging on a hot day, sweating on a hot day, slogging and sweating		
split in two	pose	being split in two, being disembowelled		
surfing	pose	surfing a big wave, riding a surfboard		
targeted	pose	feeling targeted with a bullseye, wearing a bullseye, being the centre of attention  		
nocking	pose	nocking an arrow in a bow, preparing to shoot an arrow from a bow		
rollerskating	pose	rollerskating, eating pizza while rollerskating, relaxing on rollerskates		
skating	pose	figure skating on ice, going ice skating		
sitting	pose	sitting on a decorative urn, sitting on a Ming vase		
slurping	pose	drinking a pint of Guinness, enjoying a pint of beer		
arriving	pose	arriving with a suitcase, turning up with a suitcase, waving while carrying a suitcase		
tempting	pose	making a tempting offer, being seductively tempting, tempting someover over to the dark side, making an offer you can't refuse, doing the devil's work		
watching TV	pose	watching TV, watching a TV show		
watering	pose	watering a plant, tending a plant with a watering can		
spreading	pose	blowing on a dandelion, spreading dandelion seeds		
nude	pose	posing in the nude, posing for Playboy magazine, posing for a nude photo		
mauled by dog	pose	being mauled by a vicious dog		
fleeing	pose	fleeing the scene of the crime, going on the run, getting the hell out of Dodge, making a run for it		
centaur	pose	a centaur		
bending to see	pose	bending down to see with a magnifying glass		
sitting on box	pose	sitting on a box, sitting on a crate, sitting on a packing crate		
sitting on rock	pose	sitting on a rock		
hulking	pose	turning into a hulking monster, turning into the incredible Hulk		
rumbling	pose	suffering from a nervous stomach, suffering from a stomach ache, suffering from indigestion, getting a bad feeling in the gut, rumbling with hunger		
crucified with beard	pose	being crucified for their beliefs		
spiky	pose	feeling in a prickly mood, making barbed comments, exhibiting a spiky personality		
suave	pose	behaving in a suave manner, suavely carrying an umbrella, taking a gentlemanly stroll		
attracting	pose	attracting others, exuding pure magnetism, exuding an animal magnetism, cutting a very attractive figure		
stepping over	pose	stepping over a pile of dog shit, stepping over a pile of poop, stepping over a dog turd		
stepping up	pose	stepping up, stepping into the fray		
stepping down	pose	stepping down, putting their best foot forward		
regaining consciousness	pose	regaining consciousness, awakening from a coma, waking up after a long sleep		
weighing	pose	carefully weighing all the options, weighing the alternatives		
guessing	pose	taking a wild guess, flipping a coin, gambling everything on the toss of a coin, making a random decision		
tossing drink	pose	tossing a drink away, soshing beer everywhere		
timekeeping	pose	keeping an eye on the time, keeping one eye on the clock, watching the clock		
chuckling	pose	chuckling, laughing maniacally, having a good laugh, having a belly laugh, laughing heartily		
handy	pose	choosing the right tool for the job, getting ready for a job, gathering the tools for a job, inspecting the tools		
warrior	pose	getting ready to do battle, charging into battle, wearing armour and carrying a sword		
rowing	pose	rowing a rowboat, rowing a small boat		
greeting	pose	greeting with a smile, welcoming guests with a smile, giving a warm greeting		
sprinting	pose	sprinting at top speed, running the 100 meter dash, running in a foot race, jogging and sweating		
spraying paint	pose	spraying paint, spraying graffiti on the wall		
hitler	pose	extolling fascism, subjugating minorities, oppressing minorities		
blowdrying	pose	drying hair with a blowdryer, styling hair with a blowdryer,   maintaining salon-quality hair, using a hairdryer		
blowing balloon	pose	inflating a balloon, blowup up a party balloon, blowing a sbubble, inflating a bubble		
poxy	pose	suffering from a terrible disease, suffering from a contagious disease, shivering with the pox		
shivering	pose	shivering with the cold, coming down with a cold		
opening can	pose	opening a tin can with a can opener		
opening jar	pose	opening a jar, opening the cookie jar		
drinking from bottle	pose	drinking straight from the bottle, drinking the last drop		
looking in mirror	pose	looking in the mirror, looking in the mirror while blowdrying hair, looking in the mirror while using a blowdryer		
blending	pose	using a kitchen blender, making a mess with a kitchen blender		
mixing	pose	mixing and blending ingredients, mixing a cocktail, cooking up a storm		
reacting	pose	producing a chemical reaction, combining chemicals to create a reaction, experimenting with chemicals		
icarus	pose	falling off one's perch, suffering a sudden fall from grace, flying too close to the sun 		
on crutch	pose	hobbling around on a crutch, hobbling around on one leg		
broken legs	pose	sitting in a wheelchair with two broken legs, suffering from two broken legs		
hacking	pose	hacking into the mainframe, using a computer for illicit purposes 		
tortoise	pose	crawling around like a tortoise		
calculating	pose	using a calculator, calculating some numbers on a calculator, running the numbers on a calculator		
rent a nude mob	pose	attending a nudist colony		
loving twosome	pose	having a romantic moment, cuddling and kissing		
holding branch	pose	holding out an olive branch, holding a tree branch		
holding club	pose	swinging a giant club, brandishing a giant club		
holding flower	pose	holding a flower, arriving with flowers, holding a bouquet of flowers, giving flowers		
holding fireball	pose	holding a fireball, holding a ball of fire, creating a fireball		
holding whirlwind	pose	unleashing a whirlwind, holding a whirlwind, stirring up a whirlwind		
holding globe	pose	holding a globe of the Earth, holding a map of the Earth		
drilling	pose	drilling for oil, finding oil		
mining	pose	mining coal, swinging a pickaxe, digging coal		
holding ball	pose	holding a ball		
holding drum	pose	holding a drum, playing the drums		
playing tennis	pose	playing tennis, serving the ball in tennis, hitting a serve in tennis, swinging a tennis racket 		
playing banjo	pose	playing the banjo		
dunking	pose	dunking a basketball, slamdunking a basketball		
playing guitar	pose	playing the guitar		
playing violin	pose	playing the violin		
snacking	pose	eating a donut, eating a box of donuts, enjoying a snack		
rent a scared mob	pose			
giving chocolate	pose	giving a box of chocolates, going down on bended knee with a box of chocolates		
gifting	pose	giving a gift, making origami, making an origami unicorn, giving a very special gift		
rent a mob	pose	rousing the rabble, leading a mob		
rent a mob with beard	pose			
blowing a trumpet	pose	blowing a trumpet, blowing one's own horn		
drowning	pose	drowning in deep water		
lost	pose	feeling lost and confused		
on treadmill	pose	running on a treadmill		
sweating	pose	sweating profusely, feeling hot and sweaty		
speeding	pose	driving like a demon, breaking the speed limit, driving too fast, burning rubber and driving too fast		
green light	pose	getting the green light to drive on		
red light	pose	waiting impatiently at a red light, waiting impatiently for the lights to change		
busy traffic in city	setting	a traffic jam, a street clogged with cars and traffic		
polluting traffic	setting	polluting traffic, a noisy traffic jam, a traffic jam in a heavily polluted city		
classroom	setting	a class room with a blackboard and lectern, a college classroom, the front of a lecture theatre		
